1111111111111111
1C00000000001001
1000010100001101
1P0011E1000C0001
1111111100001111
1C00000000001001
1000010100001101
10001101000C0001
1111111111111111
